##########
#D------D#
#--------#
#-B------#
#----B---#
#--------#
#--------#
#--P--B--#
#-------D#
########## 