###############
#D---B---B---D#
#-------------#
#-------------#
#-------------#
#D--B---------#
#-----P-------#
#-------------#
#-------------#
#-------------#
#-------------#
#-------B----D#
#-------------#
#D-B------B--D#
###############  