###############
#P-----------D#
#-------------#
#---------B---#
#-------------#
#--------B----#
#-------------#
#-------------#
#-------------#
#-------------#
#-------------#
#--D-----B----#
#-------------#
#--D----------#
############### 
