##########
#D---D---#
#-B------#          
#-----B--#
#-B-----D#
#----P---#
#-B---D--#
#--------#
#DB----BD#
########## 